NO ./textures/no.xpm
SO ./textures/so.xpm
EA ./textures/ea.xpm
WE ./textures/we.xpm

F 70,70,70
C 10,50,90

        1111111111111111111111111
        1000000000110000000000001
        1011000001110000001000001
        10010000000000000001000001         111111111
111111111011000001110000000000001          100000001
10D0000000000000011100001111111111         111111111
111101111100110111000000000111
111100111100110111D111100000111111
1101100011000001100011111000111111
100010000100000D00001   100000111
10000000000000011111111110000011
11000001111111011111111110N000111
11110111     1000111 0111100111111
11111111     1111111 111111111111
