NO ./textures/no.xpm
SO ./textures/so.xpm
EA ./textures/ea.xpm
WE ./textures/we.xpm

F 40,40,40
C 0,0,0

   111111
1111000W1
110000001
110000001
110000001
110000001
110001001
111111111
